14
8
1, 1, 1, 1, 1, 1, 1, 1, 1, 1, 1, 1, 1,1,
1, 0, 0, 0, 0, 0, 0, 0, 0, 0, 0, 0, 0,1,
1, 0, 0, 0, 0, 0, 0, 0, 0, 0, 0, 0, 0,1,
1, 0, 0, 0, 0, 0, 0, 0, 0, 0, 0, 0, 0,1,
1, 0, 0, 0, 0, 0, 0, 0, 0, 0, 0, 0, 0,1,
1, 0, 0, 0, 0, 0, 0, 0, 0, 0, 0, 0, 0,1,
1,50, 9, 9, 9, 9, 9, 9, 9, 9, 9, 9,60,1,
1, 1, 1, 1, 1, 1, 1, 1, 1, 1, 1, 1, 1,1,
